{
    "COD":"REAL",
    "POP":30,
    "DIM":100,
    "ITERATIONS":1000,
    "TYPE":"LABIRINTO",
    "MUTATION_RATE":0.03,
    "CROSSOVER_RATE":0.8,
    "PENALITY":-1.0,
    "ELITISM":1,
    "WIN_RATE":0.9,
    "MAP": [
            [0,0,0,0,0,0,0,0,0,0,0,0,0,0,0,0,0,0,0,0,0,0,0,0,0],
            [0,0,1,1,0,0,0,0,1,1,1,1,1,1,1,1,1,1,1,0,3,1,1,0,0],
            [0,1,1,1,1,1,1,1,1,0,1,0,1,0,1,0,0,0,0,0,0,0,1,1,0],
            [0,1,0,0,0,0,0,0,1,0,1,0,1,0,1,0,0,0,0,0,0,0,1,0,0],
            [0,1,1,1,1,1,1,0,1,0,1,0,1,0,1,0,1,1,1,0,1,1,1,1,0],
            [0,1,0,0,0,0,1,0,1,0,1,0,1,0,1,0,1,0,0,0,0,0,0,1,0],
            [0,1,0,0,0,0,1,0,1,1,1,1,1,1,1,0,1,1,1,1,1,0,1,1,0],
            [0,1,0,0,0,0,1,0,0,0,0,0,0,0,1,0,1,0,1,0,1,0,0,1,0],
            [0,1,1,1,1,1,1,1,0,1,1,0,1,1,1,0,1,0,1,0,1,0,1,1,0],
            [0,0,0,0,0,0,1,1,0,1,1,0,1,1,1,0,1,0,1,0,1,0,0,1,0],
            [0,2,1,1,1,0,1,0,0,1,1,0,1,0,0,0,1,0,1,0,1,0,1,1,0],
            [0,1,0,0,1,0,1,0,0,1,1,0,1,0,0,0,1,0,1,0,1,1,1,1,0],
            [0,1,0,0,1,0,1,0,0,1,0,0,1,0,0,0,1,0,1,0,0,0,0,1,0],
            [0,1,0,0,1,0,1,1,0,1,0,1,1,1,1,1,1,0,1,0,1,1,1,1,0],
            [0,1,0,0,1,0,1,1,0,1,0,0,0,0,0,0,0,0,1,0,1,0,0,1,0],
            [0,1,1,0,1,0,0,1,1,1,0,0,0,0,0,1,1,1,1,0,1,0,0,1,0],
            [0,1,1,0,1,0,0,1,1,1,1,1,1,1,1,1,0,0,0,0,1,0,1,1,0],
            [0,0,1,0,1,0,1,1,0,0,0,0,0,0,0,1,1,1,1,0,1,0,1,0,0],
            [0,1,1,0,0,0,1,1,0,1,1,1,1,0,0,0,0,0,1,0,1,1,1,1,0],
            [0,1,1,1,1,1,1,1,0,1,1,1,1,1,1,1,1,1,1,0,1,0,0,1,0],
            [0,0,0,0,1,0,0,0,0,1,1,0,1,1,1,0,1,0,1,0,1,1,0,1,0],
            [0,1,1,1,1,0,1,1,1,1,1,0,1,0,1,0,1,0,1,0,0,1,0,1,0],
            [0,1,1,0,1,0,1,0,0,0,1,0,1,0,1,0,1,0,1,0,1,1,0,1,0],
            [0,1,1,0,1,0,1,0,0,0,1,0,1,0,1,0,1,0,1,0,1,0,0,1,0],
            [0,1,1,0,1,0,1,0,0,0,1,0,1,0,1,0,1,0,1,0,1,1,0,1,0],
            [0,1,1,0,1,0,1,0,0,0,1,0,1,0,1,0,1,0,0,0,0,1,0,1,0],
            [0,0,0,0,1,0,1,1,1,1,1,1,1,1,1,0,1,0,0,1,1,1,1,1,0],
            [0,1,1,1,1,0,1,0,0,0,0,0,0,0,0,0,1,0,0,1,0,0,1,0,0],
            [0,1,1,0,1,0,1,1,1,1,1,1,1,1,1,1,1,1,1,1,1,1,1,1,0],
            [0,0,0,0,0,0,0,0,0,0,0,0,0,0,0,0,0,0,0,0,0,0,0,0,0]
            ]
            
}

